111111111111111
1P0000000000E011
1000000000000001
1000000C00000001
1000000000000001
1000000000000001
1000000000000001
1111111111111111
