1111111111
1P000000E1
1011111111
1000000001
1011111101
1000000001
1011111101
1000000001
10000C0001
1111111111