1111111111111111
1P000C000000C0011
10000000000000001
10111111111111001
101C0000000000001
10111111111111001
1E000000000000001
1111111111111111
